OOOOOOOOO
O. OO   O
OO O   XO
OOOOO O.O
OO O    U
OOOOOOO.O
OO      O
OO OOOOOO
O. O    O
OOOOOOOOO